111111111111111111111111111111
112222222222221122222222222211
113111121111121121111121111311
112111121111121121111121111211
112111121111121121111121111211
112222222222222222222222222211
112111121121111111121121111211
112111121121111111121121111211
112222221122221122221122222211
111111121111101101111121111111
000001121111101101111121100000
000001121100000700001121100000
000001121101110011101121100000
111111121101110011101121111111
000000020001000000100020000000
111111121101706009101121111111
000001121101111111101121100000
000001121100000000001121100000
000001121101111111101121100000
111111121101111111101121111111
112222222222221122222222222211
112111121111121121111121111211
112111121111121121111121111211
113221122222220522222221122311
111121121121111111121121121111
111121121121111111121121121111
112222221122221122221122222211
112111111111121121111111111211
112111111111121121111111111211
112222222222222222222222222211
111111111111111111111111111111