111111111111111111111111111111
110000000000001100000000000011
110111101111101101111101111011
110111101111101101111101111011
110111101111101101111101111011
110000000000000000000000000011
110111101101111111101101111011
110111101101111111101101111011
110000001100001100001100000011
111111101111101101111101111111
000001101111101101111101100000
000001101100000700001101100000
000001101101110011101101100000
111111101101110011101101111111
000000000001100001100000000000
111111101101100001101101111111
000001101101111111101101100000
000001101100000000001101100000
000001101101111111101101100000
111111101101111111101101111111
110000000000001100000000000011
110111101111101101111101111011
110111101111101101111101111011
110001100000000500000001100011
111101101101111111101101101111
111101101101111111101101101111
110000001100001100001100000011
110111111111101101111111111011
110111111111101101111111111011
110000000000000000000000000011
111111111111111111111111111111